Z-ZZZZZZ-ZZ
Z---Z-----Z
-.Z.--Z.Z--
Z-P-Z-----Z
ZZZZZZZZ-ZZ