-----------
-----------
ZZZZZZZZZZZ
Z---Z---2-Z
-.Z.--Z.Z34
Z-P-Z---1-Z
ZZZZZZZZZZZ